GEO.id,GEO.id2,GEO.display-label,Population,Veteran,Nonveteran,Male,Male18to34,Male35to54,Male55to64,Male65to74,Male75Plus,Female,Female18to34,Female35to54,Female55to64,Female65to74,Female75Plus
5001500US0101,101,"Congressional District 1 (115th Congress), Alabama",535051,54153,480898,254284,74294,86637,43998,30633,18722,280767,76753,92631,48689,35570,27124
5001500US0102,102,"Congressional District 2 (115th Congress), Alabama",519658,59017,460641,246618,75465,83943,41366,28570,17274,273040,77053,90660,45191,32924,27212
5001500US0103,103,"Congressional District 3 (115th Congress), Alabama",541600,53241,488359,259220,82557,87786,43058,29225,16594,282380,84325,92397,46667,33529,25462
5001500US0104,104,"Congressional District 4 (115th Congress), Alabama",527135,44186,482949,254624,70193,88827,44384,32232,18988,272511,68696,90618,47311,37129,28757
5001500US0105,105,"Congressional District 5 (115th Congress), Alabama",545650,57936,487714,263418,78788,94142,44472,28220,17796,282232,77705,97507,47165,33243,26612
5001500US0106,106,"Congressional District 6 (115th Congress), Alabama",529980,43762,486218,253586,73010,94088,43015,27109,16364,276394,74175,97245,46763,32114,26097
5001500US0107,107,"Congressional District 7 (115th Congress), Alabama",524751,39166,485585,240439,86845,75077,39812,24336,14369,284312,94130,86390,47603,29676,26513
5001500US0200,200,"Congressional District (at Large) (115th Congress), Alaska",532857,68145,464712,274301,94059,97182,48866,23996,10198,258556,86916,91282,45247,22581,12530
5001500US0401,401,"Congressional District 1 (115th Congress), Arizona",554180,54588,499592,277892,88334,88206,43710,35919,21723,276288,81658,82699,48696,38444,24791
5001500US0402,402,"Congressional District 2 (115th Congress), Arizona",563411,75893,487518,273086,81559,82760,44276,37258,27233,290325,77775,83927,50587,42061,35975
5001500US0403,403,"Congressional District 3 (115th Congress), Arizona",531413,38529,492884,263119,103738,88542,35726,21736,13377,268294,97358,89833,38704,24641,17758
5001500US0404,404,"Congressional District 4 (115th Congress), Arizona",587984,85868,502116,295684,68377,83252,51045,54604,38406,292300,58087,80278,56948,57498,39489
5001500US0405,405,"Congressional District 5 (115th Congress), Arizona",562083,55211,506872,271589,75200,101700,39474,31847,23368,290494,75387,104055,44304,36029,30719
5001500US0406,406,"Congressional District 6 (115th Congress), Arizona",596609,49717,546892,290090,81180,102008,48508,35402,22992,306519,76666,105299,54465,41116,28973
5001500US0407,407,"Congressional District 7 (115th Congress), Arizona",527260,25678,501582,263006,108621,97480,32891,15816,8198,264254,104461,98166,31722,18063,11842
5001500US0408,408,"Congressional District 8 (115th Congress), Arizona",576695,70393,506302,270373,68604,91455,41798,38212,30304,306322,73881,97610,49809,45894,39128
5001500US0409,409,"Congressional District 9 (115th Congress), Arizona",591958,41460,550498,297926,123192,99334,39770,21736,13894,294032,110670,95262,42395,24580,21125
5001500US0501,501,"Congressional District 1 (115th Congress), Arkansas",553707,53319,500388,270657,78199,91928,45180,33583,21767,283050,73917,91181,48606,37936,31410
5001500US0502,502,"Congressional District 2 (115th Congress), Arkansas",573794,56425,517369,272692,88387,93448,43866,29151,17840,301102,92213,99166,48753,33983,26987
5001500US0503,503,"Congressional District 3 (115th Congress), Arkansas",578395,51016,527379,282882,96097,98208,41881,28757,17939,295513,94449,97272,45435,32762,25595
5001500US0504,504,"Congressional District 4 (115th Congress), Arkansas",550897,53189,497708,265064,73633,87752,47065,34613,22001,285833,72791,92826,49553,38626,32037
5001500US0601,601,"Congressional District 1 (115th Congress), California",562030,59151,502879,280446,82586,82343,51435,39023,25059,281584,72013,80341,55245,40896,33089
5001500US0602,602,"Congressional District 2 (115th Congress), California",568621,44326,524295,280156,72252,95056,53437,37455,21956,288465,65161,94268,57928,41222,29886
5001500US0603,603,"Congressional District 3 (115th Congress), California",541902,50353,491549,266362,93078,89061,41994,25829,16400,275540,90930,88866,43850,29183,22711
5001500US0604,604,"Congressional District 4 (115th Congress), California",564781,58402,506379,278294,67083,94138,52652,39385,25036,286487,61582,94655,56626,42386,31238
5001500US0605,605,"Congressional District 5 (115th Congress), California",571172,42400,528772,274677,83516,93523,47747,31573,18318,296495,81661,96263,54283,35226,29062
5001500US0606,606,"Congressional District 6 (115th Congress), California",551640,35922,515718,264688,99816,90246,38020,22153,14453,286952,101492,94118,43379,26400,21563
5001500US0607,607,"Congressional District 7 (115th Congress), California",556919,47799,509120,268354,81621,98744,43911,25757,18321,288565,79037,102403,48343,31672,27110
5001500US0608,608,"Congressional District 8 (115th Congress), California",507069,47448,459621,246827,78749,84385,40992,26385,16316,260242,81444,87585,43578,27513,20122
5001500US0609,609,"Congressional District 9 (115th Congress), California",534925,33727,501198,260921,87835,93430,40485,24083,15088,274004,84318,97685,42116,28232,21653
5001500US0610,610,"Congressional District 10 (115th Congress), California",528640,33196,495444,259608,87995,95273,38732,22985,14623,269032,84880,95615,41059,26293,21185
5001500US0611,611,"Congressional District 11 (115th Congress), California",571089,33828,537261,274433,79740,99116,46324,29042,20211,296656,78071,103695,50959,34435,29496
5001500US0612,612,"Congressional District 12 (115th Congress), California",643230,22615,620615,329754,116142,121175,45409,26576,20452,313476,112670,101216,41366,28850,29374
5001500US0613,613,"Congressional District 13 (115th Congress), California",597060,25981,571079,286390,102202,101197,41165,25933,15893,310670,106094,104075,46504,29980,24017
5001500US0614,614,"Congressional District 14 (115th Congress), California",590336,25687,564649,287887,87534,107221,46105,27301,19726,302449,82680,107522,50476,32897,28874
5001500US0615,615,"Congressional District 15 (115th Congress), California",569511,27843,541668,276760,81979,111196,44513,24130,14942,292751,80818,114010,47122,28761,22040
5001500US0616,616,"Congressional District 16 (115th Congress), California",499353,25055,474298,246327,97624,84292,32707,19471,12233,253026,93708,86075,34538,21846,16859
5001500US0617,617,"Congressional District 17 (115th Congress), California",582820,20097,562723,294068,97999,117115,40508,22469,15977,288752,91001,109419,40436,25321,22575
5001500US0618,618,"Congressional District 18 (115th Congress), California",565219,28064,537155,278164,79205,106629,45475,26580,20275,287055,71934,109811,46311,30503,28496
5001500US0619,619,"Congressional District 19 (115th Congress), California",569228,22184,547044,285180,97332,109044,41143,23341,14320,284048,89019,104146,43559,26198,21126
5001500US0620,620,"Congressional District 20 (115th Congress), California",542480,29938,512542,271076,96865,92922,42142,23980,15167,271404,90836,88423,42987,26586,22572
5001500US0621,621,"Congressional District 21 (115th Congress), California",481577,21490,460087,258621,106248,94362,31873,16134,10004,222956,84562,78870,28640,17026,13858
5001500US0622,622,"Congressional District 22 (115th Congress), California",529459,33153,496306,257133,92772,88825,36996,23189,15351,272326,92011,90763,40454,26422,22676
5001500US0623,623,"Congressional District 23 (115th Congress), California",528356,44275,484081,265245,92282,93060,40998,24026,14879,263111,85020,89018,41638,27016,20419
5001500US0624,624,"Congressional District 24 (115th Congress), California",572757,42469,530288,286640,107014,85962,43394,29116,21154,286117,96482,81926,46317,31965,29427
5001500US0625,625,"Congressional District 25 (115th Congress), California",525281,32739,492542,258878,82724,99299,42902,22057,11896,266403,76550,104571,42804,24672,17806
5001500US0626,626,"Congressional District 26 (115th Congress), California",540293,36532,503761,264024,83906,93264,42803,26114,17937,276269,80426,95410,45613,29052,25768
5001500US0627,627,"Congressional District 27 (115th Congress), California",576099,22215,553884,274679,80421,98833,45037,27932,22456,301420,77851,104257,51677,34749,32886
5001500US0628,628,"Congressional District 28 (115th Congress), California",601716,19212,582504,299377,100065,110868,43889,25411,19144,302339,95083,101917,46017,30446,28876
5001500US0629,629,"Congressional District 29 (115th Congress), California",540590,15128,525462,268254,102612,100392,35781,18300,11169,272336,97122,97736,38196,21065,18217
5001500US0630,630,"Congressional District 30 (115th Congress), California",598687,24974,573713,291484,92509,107303,45185,26459,20028,307203,88537,108555,49571,30981,29559
5001500US0631,631,"Congressional District 31 (115th Congress), California",533837,29823,504014,258367,100643,91164,35811,19594,11155,275470,98010,95314,40382,23476,18288
5001500US0632,632,"Congressional District 32 (115th Congress), California",550312,21591,528721,268128,95525,94086,39344,24204,14969,282184,89338,95980,45028,27487,24351
5001500US0633,633,"Congressional District 33 (115th Congress), California",581119,28471,552648,278090,79725,100163,44689,30161,23352,303029,86546,107866,45557,33414,29646
5001500US0634,634,"Congressional District 34 (115th Congress), California",564253,11848,552405,287601,114120,105961,35223,19528,12769,276652,98862,94965,37795,23942,21088
5001500US0635,635,"Congressional District 35 (115th Congress), California",530580,19915,510665,264409,104735,98638,34425,16883,9728,266171,98255,98196,35079,19910,14731
5001500US0636,636,"Congressional District 36 (115th Congress), California",558331,47564,510767,277591,77349,88792,42312,37717,31421,280740,73405,85542,43831,41459,36503
5001500US0637,637,"Congressional District 37 (115th Congress), California",579015,18891,560124,275880,108148,97399,34582,19924,15827,303135,105888,101595,43303,27760,24589
5001500US0638,638,"Congressional District 38 (115th Congress), California",548479,24356,524123,264531,89643,93803,40060,23580,17445,283948,85730,98859,44157,29195,26007
5001500US0639,639,"Congressional District 39 (115th Congress), California",563287,27310,535977,272611,87971,95598,45393,25904,17745,290676,84887,102148,48619,29642,25380
5001500US0640,640,"Congressional District 40 (115th Congress), California",499786,9029,490757,244982,96620,93922,30095,14913,9432,254804,97702,93334,31532,18466,13770
5001500US0641,641,"Congressional District 41 (115th Congress), California",534953,29691,505262,261660,105560,91924,35084,18488,10604,273293,104175,95027,37050,20551,16490
5001500US0642,642,"Congressional District 42 (115th Congress), California",551730,44825,506905,270803,88878,104176,40327,22556,14866,280927,84714,106601,41958,27065,20589
5001500US0643,643,"Congressional District 43 (115th Congress), California",544614,23262,521352,257350,91905,94837,36403,20347,13858,287264,96103,102801,41441,25298,21621
5001500US0644,644,"Congressional District 44 (115th Congress), California",515404,15850,499554,248159,95021,91803,33078,17157,11100,267245,96735,95895,35702,21785,17128
5001500US0645,645,"Congressional District 45 (115th Congress), California",584700,31154,553546,280883,86332,105836,43915,26306,18494,303817,83138,112843,47878,31947,28011
5001500US0646,646,"Congressional District 46 (115th Congress), California",532644,16561,516083,266088,107229,99385,31949,16469,11056,266556,101169,95317,32952,20249,16869
5001500US0647,647,"Congressional District 47 (115th Congress), California",551544,29055,522489,269214,90445,99398,40059,23634,15678,282330,87921,103079,42940,26099,22291
5001500US0648,648,"Congressional District 48 (115th Congress), California",577915,34158,543757,282815,82517,101108,47551,30851,20788,295100,77777,103688,50058,34602,28975
5001500US0649,649,"Congressional District 49 (115th Congress), California",533636,46737,486899,258534,74295,95985,42524,27249,18481,275102,76032,99170,45372,29370,25158
5001500US0650,650,"Congressional District 50 (115th Congress), California",550578,54686,495892,268531,84103,96012,44126,27150,17140,282047,80815,99356,47528,29411,24937
5001500US0651,651,"Congressional District 51 (115th Congress), California",521874,33881,487993,257016,100964,87721,35070,18885,14376,264858,92146,89703,38110,23957,20942
5001500US0652,652,"Congressional District 52 (115th Congress), California",575966,53885,522081,282269,98027,97818,41826,26248,18350,293697,95430,98573,44359,29770,25565
5001500US0653,653,"Congressional District 53 (115th Congress), California",586170,61889,524281,287020,106621,100850,39847,22914,16788,299150,107671,97729,41943,26906,24901
5001500US0801,801,"Congressional District 1 (115th Congress), Colorado",622382,39253,583129,309299,116874,111581,42911,23700,14233,313083,115042,103283,44911,27437,22410
5001500US0802,802,"Congressional District 2 (115th Congress), Colorado",617539,45929,571610,309634,108119,102248,52720,30584,15963,307905,99682,101288,53123,32047,21765
5001500US0803,803,"Congressional District 3 (115th Congress), Colorado",565456,56320,509136,282750,82453,92283,52105,35137,20772,282706,76326,90785,53673,35676,26246
5001500US0804,804,"Congressional District 4 (115th Congress), Colorado",565958,49282,516676,283855,85392,107006,47254,28583,15620,282103,78987,103838,48270,29601,21407
5001500US0805,805,"Congressional District 5 (115th Congress), Colorado",549881,96434,453447,269555,86484,94456,45204,27921,15490,280326,84456,95916,47950,30413,21591
5001500US0806,806,"Congressional District 6 (115th Congress), Colorado",573191,48572,524619,278557,85770,112101,42835,24590,13261,294634,85612,113942,47218,28116,19746
5001500US0807,807,"Congressional District 7 (115th Congress), Colorado",585602,47909,537693,289913,98396,104444,45333,25589,16151,295689,91506,102341,47851,29848,24143
5001500US0901,901,"Congressional District 1 (115th Congress), Connecticut",561207,36457,524750,266046,79653,92871,45791,27967,19764,295161,77483,100390,50405,33083,33800
5001500US0902,902,"Congressional District 2 (115th Congress), Connecticut",560474,53492,506982,276215,81077,95047,49477,31304,19310,284259,74574,96218,51134,33528,28805
5001500US0903,903,"Congressional District 3 (115th Congress), Connecticut",571232,35848,535384,269844,87005,91856,44697,27008,19278,301388,88754,98283,49547,33426,31378
5001500US0904,904,"Congressional District 4 (115th Congress), Connecticut",555916,26292,529624,266432,75161,100556,46097,25962,18656,289484,73207,108307,48833,29875,29262
5001500US0905,905,"Congressional District 5 (115th Congress), Connecticut",557722,36670,521052,268868,72276,98141,49440,28871,20140,288854,71455,102189,51604,32935,30671
5001500US1000,1000,"Congressional District (at Large) (115th Congress), Delaware",727643,68777,658866,346317,104138,115722,58172,42132,26153,381326,105828,124020,65930,48722,36826
5001500US1198,1198,"Delegate District (at Large) (115th Congress), District of Columbia",540819,27754,513065,251852,105111,84061,32178,18636,11866,288967,122915,84676,36712,24044,20620
5001500US1201,1201,"Congressional District 1 (115th Congress), Florida",558396,96894,461502,272132,82835,90887,46390,32070,19950,286264,80088,92284,50137,35747,28008
5001500US1202,1202,"Congressional District 2 (115th Congress), Florida",563337,70799,492538,286696,84409,94645,47302,36975,23365,276641,71059,84931,50762,39901,29988
5001500US1203,1203,"Congressional District 3 (115th Congress), Florida",562120,65658,496462,274508,95705,85572,43400,30994,18837,287612,93041,87578,47357,33622,26014
5001500US1204,1204,"Congressional District 4 (115th Congress), Florida",578630,70134,508496,277096,80949,98024,47380,32587,18156,301534,83350,104032,52350,35574,26228
5001500US1205,1205,"Congressional District 5 (115th Congress), Florida",550117,57049,493068,261857,102315,85549,39159,22050,12784,288260,104842,90699,43973,27263,21483
5001500US1206,1206,"Congressional District 6 (115th Congress), Florida",595682,73168,522514,284441,68490,84572,51233,45890,34256,311241,66220,90322,58692,51270,44737
5001500US1207,1207,"Congressional District 7 (115th Congress), Florida",589067,45946,543121,284329,105374,96154,41006,25589,16206,304738,100633,100877,46742,30379,26107
5001500US1208,1208,"Congressional District 8 (115th Congress), Florida",585168,80990,504178,281025,65944,84772,52328,42686,35295,304143,62264,91426,56933,48206,45314
5001500US1209,1209,"Congressional District 9 (115th Congress), Florida",590526,48376,542150,286786,90567,101408,41551,32224,21036,303740,86747,106915,44854,37964,27260
5001500US1210,1210,"Congressional District 10 (115th Congress), Florida",577490,35964,541526,277260,95147,106640,39947,22205,13321,300230,101428,110210,44078,25645,18869
5001500US1211,1211,"Congressional District 11 (115th Congress), Florida",613473,95207,518266,294845,53056,72616,47438,67584,54151,318628,50321,73824,59096,77255,58132
5001500US1212,1212,"Congressional District 12 (115th Congress), Florida",587483,69880,517603,278314,61425,92235,47310,42970,34374,309169,62600,97306,54269,49371,45623
5001500US1213,1213,"Congressional District 13 (115th Congress), Florida",587748,66551,521197,280499,69026,90733,52437,38533,29770,307249,69817,94166,57113,43871,42282
5001500US1214,1214,"Congressional District 14 (115th Congress), Florida",575044,42444,532600,274137,94026,100856,40156,24390,14709,300907,100460,104025,44986,27818,23618
5001500US1215,1215,"Congressional District 15 (115th Congress), Florida",568967,57152,511815,274034,82855,96478,43993,30724,19984,294933,84269,100322,49350,35004,25988
5001500US1216,1216,"Congressional District 16 (115th Congress), Florida",608009,71208,536801,287621,65125,88066,47992,46282,40156,320388,65421,93667,56066,53572,51662
5001500US1217,1217,"Congressional District 17 (115th Congress), Florida",602995,80028,522967,298282,63326,79845,49725,57127,48259,304713,53976,78300,56512,62122,53803
5001500US1218,1218,"Congressional District 18 (115th Congress), Florida",591710,61898,529812,284336,65235,89695,48997,42611,37798,307374,62305,94367,54461,49477,46764
5001500US1219,1219,"Congressional District 19 (115th Congress), Florida",624697,68128,556569,301246,65010,82729,49611,57818,46078,323451,62888,86210,58513,62872,52968
5001500US1220,1220,"Congressional District 20 (115th Congress), Florida",569546,26744,542802,270579,91622,98760,40730,23233,16234,298967,91857,105818,44631,29590,27071
5001500US1221,1221,"Congressional District 21 (115th Congress), Florida",597455,49449,548006,283938,70286,89282,42214,38475,43681,313517,67247,93238,48275,47357,57400
5001500US1222,1222,"Congressional District 22 (115th Congress), Florida",593531,41760,551771,293018,74280,103106,50809,35917,28906,300513,71645,100240,50765,38498,39365
5001500US1223,1223,"Congressional District 23 (115th Congress), Florida",584329,30104,554225,274415,76157,102271,44578,29200,22209,309914,77838,111913,50051,35550,34562
5001500US1224,1224,"Congressional District 24 (115th Congress), Florida",570906,16943,553963,272183,91141,100054,41260,24147,15581,298723,94030,102666,46658,29978,25391
5001500US1225,1225,"Congressional District 25 (115th Congress), Florida",591085,18950,572135,285445,81895,107755,38433,30833,26529,305640,77677,110542,43850,38597,34974
5001500US1226,1226,"Congressional District 26 (115th Congress), Florida",591267,22162,569105,284627,91509,107727,41187,26511,17693,306640,87731,111848,47837,32365,26859
5001500US1227,1227,"Congressional District 27 (115th Congress), Florida",603290,16547,586743,293361,86540,109961,42019,30242,24599,309929,81723,106135,47568,35404,39099
5001500US1301,1301,"Congressional District 1 (115th Congress), Georgia",532989,67342,465647,252929,85217,85651,40065,26867,15129,280060,89386,92265,44971,31007,22431
5001500US1302,1302,"Congressional District 2 (115th Congress), Georgia",506289,51238,455051,239768,78597,81604,40261,25204,14102,266521,79775,86303,45260,30640,24543
5001500US1303,1303,"Congressional District 3 (115th Congress), Georgia",534523,55331,479192,253279,74673,93595,41767,28762,14482,281244,79416,101067,45398,32487,22876
5001500US1304,1304,"Congressional District 4 (115th Congress), Georgia",539066,44466,494600,246734,83153,94130,39048,20734,9669,292332,86995,112329,49703,26547,16758
5001500US1305,1305,"Congressional District 5 (115th Congress), Georgia",582588,36354,546234,278017,113536,98747,34521,20828,10385,304571,121046,99290,39650,25648,18937
5001500US1306,1306,"Congressional District 6 (115th Congress), Georgia",549859,32837,517022,268657,78084,112085,42218,23289,12981,281202,75384,114831,45455,27052,18480
5001500US1307,1307,"Congressional District 7 (115th Congress), Georgia",548095,32040,516055,267175,81461,117123,38779,20310,9502,280920,80059,121761,41242,23091,14767
5001500US1308,1308,"Congressional District 8 (115th Congress), Georgia",529792,55105,474687,254695,82906,88315,40561,26765,16148,275097,81976,92257,44300,31469,25095
5001500US1309,1309,"Congressional District 9 (115th Congress), Georgia",547777,48487,499290,266310,72884,93373,44278,35773,20002,281467,72245,95546,47628,39382,26666
5001500US1310,1310,"Congressional District 10 (115th Congress), Georgia",548913,43678,505235,263505,87730,92679,40456,28151,14489,285408,89552,96848,44278,32457,22273
5001500US1311,1311,"Congressional District 11 (115th Congress), Georgia",554654,44575,510079,267890,87106,105143,40078,23809,11754,286764,87686,110296,43663,27492,17627
5001500US1312,1312,"Congressional District 12 (115th Congress), Georgia",529510,57124,472386,255629,89172,86008,40874,25396,14179,273881,86310,89825,45066,30202,22478
5001500US1313,1313,"Congressional District 13 (115th Congress), Georgia",528525,50696,477829,240971,77340,96033,37956,19504,10138,287554,85021,116498,43983,25110,16942
5001500US1314,1314,"Congressional District 14 (115th Congress), Georgia",522806,43060,479746,252381,74596,96265,39968,26849,14703,270425,75066,98330,43095,30731,23203
5001500US1501,1501,"Congressional District 1 (115th Congress), Hawaii",543294,56499,486795,262147,78200,89781,42267,29390,22509,281147,78729,90302,43962,33324,34830
5001500US1502,1502,"Congressional District 2 (115th Congress), Hawaii",523421,51523,471898,255061,73608,83632,47803,31714,18304,268360,74929,86671,49217,32044,25499
5001500US1601,1601,"Congressional District 1 (115th Congress), Idaho",619149,66050,553099,307499,89677,105186,51954,38209,22473,311650,84950,105521,54116,39691,27372
5001500US1602,1602,"Congressional District 2 (115th Congress), Idaho",581555,52263,529292,288444,98075,95243,46083,30199,18844,293111,95712,93272,47569,31041,25517
5001500US1701,1701,"Congressional District 1 (115th Congress), Illinois",545465,33619,511846,248790,79509,85873,42571,24013,16824,296675,85106,98317,50511,32399,30342
5001500US1702,1702,"Congressional District 2 (115th Congress), Illinois",531400,38420,492980,242902,75369,84442,41118,25057,16916,288498,78378,100322,50752,32443,26603
5001500US1703,1703,"Congressional District 3 (115th Congress), Illinois",544328,28673,515655,267008,82702,98621,45442,25169,15074,277320,78846,97533,45792,29160,25989
5001500US1704,1704,"Congressional District 4 (115th Congress), Illinois",514814,13000,501814,260083,102868,97916,32351,16579,10369,254731,96461,92121,32940,18911,14298
5001500US1705,1705,"Congressional District 5 (115th Congress), Illinois",595178,21200,573978,289467,112541,101920,37478,21952,15576,305711,117715,96809,39815,26207,25165
5001500US1706,1706,"Congressional District 6 (115th Congress), Illinois",550037,30574,519463,265680,69697,101862,50137,27856,16128,284357,67784,107229,53381,30781,25182
5001500US1707,1707,"Congressional District 7 (115th Congress), Illinois",573034,22612,550422,268524,108844,88743,36637,21895,12405,304510,116835,96721,42828,27170,20956
5001500US1708,1708,"Congressional District 8 (115th Congress), Illinois",543568,25242,518326,269048,87484,102790,43094,22492,13188,274520,82218,99632,44453,26857,21360
5001500US1709,1709,"Congressional District 9 (115th Congress), Illinois",571083,25256,545827,275931,81949,98087,46945,27449,21501,295152,80473,97283,49991,32428,34977
5001500US1710,1710,"Congressional District 10 (115th Congress), Illinois",525091,30339,494752,255208,74169,96032,43149,24932,16926,269883,69905,99566,46566,27908,25938
5001500US1711,1711,"Congressional District 11 (115th Congress), Illinois",530349,28960,501389,256990,83799,101623,37619,21908,12041,273359,82870,104885,41882,24698,19024
5001500US1712,1712,"Congressional District 12 (115th Congress), Illinois",542806,60990,481816,264502,81056,90167,45894,28232,19153,278304,76389,91375,47790,32516,30234
5001500US1713,1713,"Congressional District 13 (115th Congress), Illinois",563945,48372,515573,274040,102011,83542,43821,25903,18763,289905,100629,83865,46171,30078,29162
5001500US1714,1714,"Congressional District 14 (115th Congress), Illinois",532717,35144,497573,261451,69599,107999,45247,25430,13176,271266,66295,110819,45536,29082,19534
5001500US1715,1715,"Congressional District 15 (115th Congress), Illinois",544920,52644,492276,269861,77153,91290,47287,31599,22532,275059,70055,87346,48718,34747,34193
5001500US1716,1716,"Congressional District 16 (115th Congress), Illinois",541841,47710,494131,267480,76468,92643,47429,30531,20409,274361,72214,91029,47410,32951,30757
5001500US1717,1717,"Congressional District 17 (115th Congress), Illinois",539002,49238,489764,262990,76720,87165,46618,30744,21743,276012,74335,86238,48445,34666,32328
5001500US1718,1718,"Congressional District 18 (115th Congress), Illinois",554233,51467,502766,270970,77499,92758,47449,31370,21894,283263,73429,92741,49769,34124,33200
5001500US1801,1801,"Congressional District 1 (115th Congress), Indiana",546222,44093,502129,264628,78883,93310,47324,27408,17703,281594,76156,95849,50181,32067,27341
5001500US1802,1802,"Congressional District 2 (115th Congress), Indiana",540466,42742,497724,263482,79730,90687,45880,28363,18822,276984,78156,91308,47187,31322,29011
5001500US1803,1803,"Congressional District 3 (115th Congress), Indiana",542719,43032,499687,263939,80103,92422,46060,27988,17366,278780,78804,93432,47740,31455,27349
5001500US1804,1804,"Congressional District 4 (115th Congress), Indiana",568873,46887,521986,283377,97625,95223,44589,27918,18022,285496,86531,93358,46777,31428,27402
5001500US1805,1805,"Congressional District 5 (115th Congress), Indiana",564668,42044,522624,270058,79567,101954,44578,26907,17052,294610,81392,106355,48884,31354,26625
5001500US1806,1806,"Congressional District 6 (115th Congress), Indiana",556058,50112,505946,271324,78720,94687,46507,31324,20086,284734,76147,94735,48649,35230,29973
5001500US1807,1807,"Congressional District 7 (115th Congress), Indiana",552926,42048,510878,261995,95164,94694,39411,20273,12453,290931,102508,98492,43659,25156,21116
5001500US1808,1808,"Congressional District 8 (115th Congress), Indiana",558734,50065,508669,275596,83075,93348,48714,30798,19661,283138,77686,90767,49600,34118,30967
5001500US1809,1809,"Congressional District 9 (115th Congress), Indiana",574076,49727,524349,279744,91685,95340,45859,29408,17452,294332,90297,95978,48652,33329,26076
5001500US1901,1901,"Congressional District 1 (115th Congress), Iowa",592455,52122,540333,290859,88439,95640,50805,31809,24166,301596,85457,94101,51165,34706,36167
5001500US1902,1902,"Congressional District 2 (115th Congress), Iowa",598217,50409,547808,294922,94039,96032,51047,31959,21845,303295,89283,94727,51327,34462,33496
5001500US1903,1903,"Congressional District 3 (115th Congress), Iowa",599696,49434,550262,291482,90232,106271,47710,28503,18766,308214,90263,106127,50420,32204,29200
5001500US1904,1904,"Congressional District 4 (115th Congress), Iowa",587010,51312,535698,291579,91869,89435,52048,31806,26421,295431,81198,87545,51417,34411,40860
5001500US2001,2001,"Congressional District 1 (115th Congress), Kansas",529520,47613,481907,262700,89167,80679,44022,27394,21438,266820,84115,78180,43324,29010,32191
5001500US2002,2002,"Congressional District 2 (115th Congress), Kansas",546610,54775,491835,268451,87240,86459,45303,29685,19764,278159,82926,85920,47496,32209,29608
5001500US2003,2003,"Congressional District 3 (115th Congress), Kansas",551632,40687,510945,266208,82207,100734,43238,24667,15362,285424,82395,103188,47506,28355,23980
5001500US2004,2004,"Congressional District 4 (115th Congress), Kansas",531856,49265,482591,259695,81482,87843,45236,26233,18901,272161,80301,88479,46651,29012,27718
5001500US2101,2101,"Congressional District 1 (115th Congress), Kentucky",549701,49853,499848,266001,75472,89416,47088,33393,20632,283700,74535,91415,49388,37543,30819
5001500US2102,2102,"Congressional District 2 (115th Congress), Kentucky",563873,57541,506332,273205,82192,96295,46614,30432,17672,290668,82222,98863,48882,33783,26918
5001500US2103,2103,"Congressional District 3 (115th Congress), Kentucky",571670,48834,522836,270747,86207,94119,46084,26937,17400,300923,87670,98624,51891,32751,29987
5001500US2104,2104,"Congressional District 4 (115th Congress), Kentucky",561496,49798,511698,276121,78846,104522,47575,28967,16211,285375,76227,103398,49423,32253,24074
5001500US2105,2105,"Congressional District 5 (115th Congress), Kentucky",553087,38293,514794,271472,77104,96131,47639,32546,18052,281615,72074,96439,50696,36183,26223
5001500US2106,2106,"Congressional District 6 (115th Congress), Kentucky",583237,45518,537719,281621,95211,99080,43914,27717,15699,301616,95750,100688,48370,32187,24621
5001500US2201,2201,"Congressional District 1 (115th Congress), Louisiana",607990,44035,563955,291054,89660,99976,50781,31498,19139,316936,92228,104794,54556,36114,29244
5001500US2202,2202,"Congressional District 2 (115th Congress), Louisiana",599304,36559,562745,282479,98931,96144,47256,26111,14037,316825,104226,104220,52651,31768,23960
5001500US2203,2203,"Congressional District 3 (115th Congress), Louisiana",581023,43054,537969,280120,92684,96152,46996,27357,16931,300903,93182,100902,49962,31189,25668
5001500US2204,2204,"Congressional District 4 (115th Congress), Louisiana",562864,57905,504959,270146,86178,90611,45057,29512,18788,292718,86273,93924,49306,34619,28596
5001500US2205,2205,"Congressional District 5 (115th Congress), Louisiana",570175,45852,524323,280517,91909,94172,46115,29962,18359,289658,84801,92530,49086,34448,28793
5001500US2206,2206,"Congressional District 6 (115th Congress), Louisiana",595225,40533,554692,286355,100020,97943,44999,27753,15640,308870,101187,104218,49226,31568,22671
5001500US2301,2301,"Congressional District 1 (115th Congress), Maine",540885,54661,486224,259393,67308,89624,48913,32745,20803,281492,67378,93306,53550,36217,31041
5001500US2302,2302,"Congressional District 2 (115th Congress), Maine",527767,59339,468428,256975,65781,84502,50895,34538,21259,270792,64380,87869,52895,35978,29670
5001500US2401,2401,"Congressional District 1 (115th Congress), Maryland",570261,54100,516161,275577,73937,95317,50000,35175,21148,294684,73046,99545,53703,38288,30102
5001500US2402,2402,"Congressional District 2 (115th Congress), Maryland",570923,50956,519967,265574,88060,96364,42085,23893,15172,305349,95651,106101,48744,29927,24926
5001500US2403,2403,"Congressional District 3 (115th Congress), Maryland",581181,47499,533682,272637,90297,94167,44573,25580,18020,308544,95531,102412,49319,32140,29142
5001500US2404,2404,"Congressional District 4 (115th Congress), Maryland",562408,50224,512184,263206,86475,98659,40527,24200,13345,299202,88088,110320,49643,30356,20795
5001500US2405,2405,"Congressional District 5 (115th Congress), Maryland",575216,66585,508631,276179,86747,102005,47010,26393,14024,299037,85647,112416,50640,30047,20287
5001500US2406,2406,"Congressional District 6 (115th Congress), Maryland",574475,43164,531311,281742,85849,106162,45964,27199,16568,292733,78074,108990,49192,30891,25586
5001500US2407,2407,"Congressional District 7 (115th Congress), Maryland",567933,40247,527686,265350,88362,90141,44278,26199,16370,302583,91131,100026,51298,32599,27529
5001500US2408,2408,"Congressional District 8 (115th Congress), Maryland",581658,39996,541662,277158,76600,103687,47677,29083,20111,304500,77901,109943,51701,33929,31026
5001500US2501,2501,"Congressional District 1 (115th Congress), Massachusetts",576181,48534,527647,272466,80180,90765,49344,31358,20819,303715,82547,98547,54106,35243,33272
5001500US2502,2502,"Congressional District 2 (115th Congress), Massachusetts",587413,42288,545125,283153,92284,97067,48602,27644,17556,304260,93063,101933,49528,30894,28842
5001500US2503,2503,"Congressional District 3 (115th Congress), Massachusetts",579266,36212,543054,283770,85827,105359,49324,26753,16507,295496,79656,109850,50631,30454,24905
5001500US2504,2504,"Congressional District 4 (115th Congress), Massachusetts",576197,35118,541079,274133,73440,104215,48408,29805,18265,302064,79401,109112,52070,32774,28707
5001500US2505,2505,"Congressional District 5 (115th Congress), Massachusetts",602822,28945,573877,287500,92301,103549,44600,27003,20047,315322,94655,106045,49873,32131,32618
5001500US2506,2506,"Congressional District 6 (115th Congress), Massachusetts",595252,41190,554062,283061,76210,101989,51333,31214,22315,312191,76081,107903,55877,37127,35203
5001500US2507,2507,"Congressional District 7 (115th Congress), Massachusetts",634666,17864,616802,303386,145927,90576,34201,19941,12741,331280,151302,94017,39247,25289,21425
5001500US2508,2508,"Congressional District 8 (115th Congress), Massachusetts",604810,38240,566570,286338,91267,100066,46712,27743,20550,318472,92354,106417,51256,33351,35094
5001500US2509,2509,"Congressional District 9 (115th Congress), Massachusetts",590357,51897,538460,281364,71060,94112,51570,38596,26026,308993,67279,100067,57180,45271,39196
5001500US2601,2601,"Congressional District 1 (115th Congress), Michigan",568030,64531,503499,287455,73046,88070,56666,41887,27786,280575,62001,83079,57206,42139,36150
5001500US2602,2602,"Congressional District 2 (115th Congress), Michigan",549085,43028,506057,268236,86368,90847,44923,28098,18000,280849,85985,90508,47109,30786,26461
5001500US2603,2603,"Congressional District 3 (115th Congress), Michigan",546373,42618,503755,267976,84063,94428,45879,26118,17488,278397,82022,94126,47293,29101,25855
5001500US2604,2604,"Congressional District 4 (115th Congress), Michigan",554146,49470,504676,275043,81906,88419,48619,34233,21866,279103,76584,86393,50219,35684,30223
5001500US2605,2605,"Congressional District 5 (115th Congress), Michigan",531014,46521,484493,252328,70196,85009,46849,30156,20118,278686,71860,90568,51099,34583,30576
5001500US2606,2606,"Congressional District 6 (115th Congress), Michigan",548491,45043,503448,267288,82703,87980,47134,30260,19211,281203,80338,89841,49425,33552,28047
5001500US2607,2607,"Congressional District 7 (115th Congress), Michigan",545735,48219,497516,272146,73367,96407,51414,31933,19025,273589,67531,92477,51429,34113,28039
5001500US2608,2608,"Congressional District 8 (115th Congress), Michigan",561281,38848,522433,273550,88525,94844,46584,28596,15001,287731,85989,98768,50116,30628,22230
5001500US2609,2609,"Congressional District 9 (115th Congress), Michigan",568353,41729,526624,271453,81432,94852,46873,28068,20228,296900,80315,97197,52320,34078,32990
5001500US2610,2610,"Congressional District 10 (115th Congress), Michigan",551840,46354,505486,271034,68656,99143,51667,32179,19389,280806,64708,101784,51551,34515,28248
5001500US2611,2611,"Congressional District 11 (115th Congress), Michigan",555661,35369,520292,268962,71330,102272,49268,28257,17835,286699,69963,104857,51954,32615,27310
5001500US2612,2612,"Congressional District 12 (115th Congress), Michigan",553024,34930,518094,266217,98237,87625,41015,23943,15397,286807,97114,91006,45910,27902,24875
5001500US2613,2613,"Congressional District 13 (115th Congress), Michigan",514176,34346,479830,239672,79448,83316,41369,22037,13502,274504,84991,90934,46088,27488,25003
5001500US2614,2614,"Congressional District 14 (115th Congress), Michigan",530910,31624,499286,245329,76475,83509,42452,25422,17471,285581,79215,95498,49865,32273,28730
5001500US2701,2701,"Congressional District 1 (115th Congress), Minnesota",513199,44226,468973,253980,79088,82814,44259,26920,20899,259219,75423,80446,43511,28570,31269
5001500US2702,2702,"Congressional District 2 (115th Congress), Minnesota",511524,40687,470837,249404,72986,96923,42274,22955,14266,262120,72564,99653,43573,25668,20662
5001500US2703,2703,"Congressional District 3 (115th Congress), Minnesota",527971,37670,490301,254433,68608,96131,47358,25475,16861,273538,68575,99267,51537,29368,24791
5001500US2704,2704,"Congressional District 4 (115th Congress), Minnesota",528398,34300,494098,253954,86653,86724,41693,23639,15245,274444,88166,88820,45654,27014,24790
5001500US2705,2705,"Congressional District 5 (115th Congress), Minnesota",547674,31060,516614,270355,109694,90242,37540,19968,12911,277319,108069,85990,38326,22819,22115
5001500US2706,2706,"Congressional District 6 (115th Congress), Minnesota",509394,41705,467689,256199,78911,100339,41412,22581,12956,253195,73865,97239,40465,24289,17337
5001500US2707,2707,"Congressional District 7 (115th Congress), Minnesota",507685,46732,460953,252171,70057,79589,46985,30999,24541,255514,65674,77310,45433,31842,35255
5001500US2708,2708,"Congressional District 8 (115th Congress), Minnesota",520697,55136,465561,262336,69390,84572,50683,34585,23106,258361,62776,80489,49387,34968,30741
5001500US2801,2801,"Congressional District 1 (115th Congress), Mississippi",570111,42880,527231,271186,83830,95912,44200,29892,17352,298925,86461,101816,47846,34508,28294
5001500US2802,2802,"Congressional District 2 (115th Congress), Mississippi",539578,33533,506045,253985,86253,84113,42667,26050,14902,285593,86351,93046,48764,31180,26252
5001500US2803,2803,"Congressional District 3 (115th Congress), Mississippi",567481,41180,526301,270135,86489,91785,44581,29446,17834,297346,86961,97767,49826,33894,28898
5001500US2804,2804,"Congressional District 4 (115th Congress), Mississippi",569492,62658,506834,273971,85145,94832,45759,30193,18042,295521,87642,99078,48906,34094,25801
5001500US2901,2901,"Congressional District 1 (115th Congress), Missouri",574892,43365,531527,265527,96940,88637,42972,22688,14290,309365,104457,98608,50266,29630,26404
5001500US2902,2902,"Congressional District 2 (115th Congress), Missouri",592310,49099,543211,281755,73681,98516,53195,32197,24166,310555,71889,104934,57557,38370,37805
5001500US2903,2903,"Congressional District 3 (115th Congress), Missouri",584369,57573,526796,288380,84418,103602,49908,31735,18717,295989,81526,102575,51211,34550,26127
5001500US2904,2904,"Congressional District 4 (115th Congress), Missouri",572012,62382,509630,279054,89939,90001,46006,31920,21188,292958,90115,90719,48586,34728,28810
5001500US2905,2905,"Congressional District 5 (115th Congress), Missouri",580276,50060,530216,276647,90757,95658,45148,26852,18232,303629,92782,97952,50248,32714,29933
5001500US2906,2906,"Congressional District 6 (115th Congress), Missouri",576968,56128,520840,282616,82848,99456,48534,31609,20169,294352,81416,99771,49481,33646,30038
5001500US2907,2907,"Congressional District 7 (115th Congress), Missouri",588480,59087,529393,284162,89600,93694,45709,33133,22026,304318,90048,94941,50297,37440,31592
5001500US2908,2908,"Congressional District 8 (115th Congress), Missouri",575588,60406,515182,284501,80516,96027,49831,34792,23335,291087,74299,93558,52132,38093,33005
5001500US3000,3000,"Congressional District (at Large) (115th Congress), Montana",794896,87936,706960,395574,115920,124383,74234,50111,30926,399322,109824,123459,76208,49573,40258
5001500US3101,3101,"Congressional District 1 (115th Congress), Nebraska",474264,45122,429142,234255,80835,76081,37903,23241,16195,240009,76692,75201,38967,25351,23798
5001500US3102,3102,"Congressional District 2 (115th Congress), Nebraska",472602,39505,433097,229711,78806,84526,35242,19321,11816,242891,79384,84288,38212,22207,18800
5001500US3103,3103,"Congressional District 3 (115th Congress), Nebraska",461952,42713,419239,228059,63958,72376,42373,27200,22152,233893,59748,71129,41599,28811,32606
5001500US3201,3201,"Congressional District 1 (115th Congress), Nevada",526409,40468,485941,270938,90695,97496,41810,25836,15101,255471,81003,89422,39633,26142,19271
5001500US3202,3202,"Congressional District 2 (115th Congress), Nevada",537727,58557,479170,271136,80388,91072,47740,34018,17918,266591,75051,87569,47858,33596,22517
5001500US3203,3203,"Congressional District 3 (115th Congress), Nevada",574508,56738,517770,280407,81165,106387,41758,33048,18049,294101,84420,105553,46162,36114,21852
5001500US3204,3204,"Congressional District 4 (115th Congress), Nevada",527965,60512,467453,257508,79861,93978,38288,28420,16961,270457,81415,94114,42916,32466,19546
5001500US3301,3301,"Congressional District 1 (115th Congress), New Hampshire",532386,51634,480752,259843,73038,91322,48831,29519,17133,272543,71584,94485,49533,31483,25458
5001500US3302,3302,"Congressional District 2 (115th Congress), New Hampshire",526463,51648,474815,258803,70055,91300,48851,30009,18588,267660,66873,91895,50697,32010,26185
5001500US3401,3401,"Congressional District 1 (115th Congress), New Jersey",563965,38018,525947,267395,83016,94674,45322,27004,17379,296570,81943,103453,49826,32517,28831
5001500US3402,3402,"Congressional District 2 (115th Congress), New Jersey",567916,43578,524338,276015,77395,95986,48462,32694,21478,291901,72382,97822,52708,37511,31478
5001500US3403,3403,"Congressional District 3 (115th Congress), New Jersey",577972,55204,522768,276912,73039,96511,48630,33951,24781,301060,67197,103155,53139,39881,37688
5001500US3404,3404,"Congressional District 4 (115th Congress), New Jersey",557179,38889,518290,264835,70679,93858,46848,30257,23193,292344,67701,98014,51011,37624,37994
5001500US3405,3405,"Congressional District 5 (115th Congress), New Jersey",575612,31743,543869,276653,69413,104004,51698,30940,20598,298959,66782,110654,54319,35196,32008
5001500US3406,3406,"Congressional District 6 (115th Congress), New Jersey",579083,25251,553832,283633,93782,103955,45612,24868,15416,295450,91167,104135,46927,28516,24705
5001500US3407,3407,"Congressional District 7 (115th Congress), New Jersey",567144,28951,538193,273308,66496,108599,51484,28106,18623,293836,62291,116966,53008,31914,29657
5001500US3408,3408,"Congressional District 8 (115th Congress), New Jersey",597537,13058,584479,296648,115261,113663,36364,18950,12410,300889,110083,106854,39262,23880,20810
5001500US3409,3409,"Congressional District 9 (115th Congress), New Jersey",578680,19476,559204,276855,87828,102399,42954,25427,18247,301825,86411,108880,47460,30628,28446
5001500US3410,3410,"Congressional District 10 (115th Congress), New Jersey",568443,21077,547366,267016,94521,98935,39436,21767,12357,301427,95056,107989,46977,28663,22742
5001500US3411,3411,"Congressional District 11 (115th Congress), New Jersey",580322,29821,550501,276456,68290,105300,49643,30794,22429,303866,68731,109501,54307,35826,35501
5001500US3412,3412,"Congressional District 12 (115th Congress), New Jersey",583683,26317,557366,281933,83700,106843,45373,26987,19030,301750,81305,108264,49592,32311,30278
5001500US3501,3501,"Congressional District 1 (115th Congress), New Mexico",534691,52273,482418,258251,83545,86397,43464,27861,16984,276440,82193,89163,48392,31948,24744
5001500US3502,3502,"Congressional District 2 (115th Congress), New Mexico",518818,53954,464864,256832,84797,78889,41600,30110,21436,261986,78383,80622,44528,32608,25845
5001500US3503,3503,"Congressional District 3 (115th Congress), New Mexico",518418,51186,467232,252412,75379,84591,43948,30426,18068,266006,72682,86967,48101,33802,24454
5001500US3601,3601,"Congressional District 1 (115th Congress), New York",565160,37037,528123,277002,76588,101536,47013,31347,20518,288158,70238,104022,48673,36583,28642
5001500US3602,3602,"Congressional District 2 (115th Congress), New York",557603,32178,525425,268954,80256,102362,45130,24704,16502,288649,76631,105751,48173,29219,28875
5001500US3603,3603,"Congressional District 3 (115th Congress), New York",567179,28619,538560,270623,63214,97202,51244,32016,26947,296556,63987,102745,53029,37001,39794
5001500US3604,3604,"Congressional District 4 (115th Congress), New York",560670,26300,534370,266704,78700,95195,45307,27670,19832,293966,75897,101016,51006,33251,32796
5001500US3605,3605,"Congressional District 5 (115th Congress), New York",596501,18876,577625,276304,92572,98551,44966,24628,15587,320197,96125,114686,51459,31825,26102
5001500US3606,3606,"Congressional District 6 (115th Congress), New York",593522,14628,578894,280100,81262,102803,47499,28452,20084,313422,84767,108048,54119,33128,33360
5001500US3607,3607,"Congressional District 7 (115th Congress), New York",574010,9050,564960,281187,116342,100791,33262,17750,13042,292823,110080,100027,38784,23799,20133
5001500US3608,3608,"Congressional District 8 (115th Congress), New York",586991,15545,571446,260219,94194,87958,39248,23020,15799,326772,105364,109592,50339,32110,29367
5001500US3609,3609,"Congressional District 9 (115th Congress), New York",572177,11784,560393,254531,89973,88211,38097,23871,14379,317646,101848,108171,50080,31624,25923
5001500US3610,3610,"Congressional District 10 (115th Congress), New York",588338,12765,575573,284160,100164,102137,39821,24807,17231,304178,110765,93550,42949,31557,25357
5001500US3611,3611,"Congressional District 11 (115th Congress), New York",567483,22798,544685,269362,82435,96290,44918,27380,18339,298121,82167,103575,48975,33664,29740
5001500US3612,3612,"Congressional District 12 (115th Congress), New York",641211,16064,625147,298522,117176,100128,36196,25803,19219,342689,144581,97105,39432,33060,28511
5001500US3613,3613,"Congressional District 13 (115th Congress), New York",606367,12604,593763,282448,116703,96817,36723,19411,12794,323919,115527,107542,46856,28088,25906
5001500US3614,3614,"Congressional District 14 (115th Congress), New York",573892,12810,561082,287485,104776,108535,37279,21598,15297,286407,93735,97529,41099,28289,25755
5001500US3615,3615,"Congressional District 15 (115th Congress), New York",534539,11193,523346,241251,101071,83597,31219,16256,9108,293288,107896,105199,38323,24635,17235
5001500US3616,3616,"Congressional District 16 (115th Congress), New York",571505,22348,549157,261341,77527,94951,41470,26867,20526,310164,83112,108274,48447,34201,36130
5001500US3617,3617,"Congressional District 17 (115th Congress), New York",555444,24170,531274,268147,77896,97565,45946,26740,20000,287297,73741,100311,48927,32755,31563
5001500US3618,3618,"Congressional District 18 (115th Congress), New York",544974,37755,507219,266031,76962,98647,46205,27128,17089,278943,71495,102989,48067,30727,25665
5001500US3619,3619,"Congressional District 19 (115th Congress), New York",571066,46665,524401,284738,76376,95542,53950,36282,22588,286328,70946,93742,53474,37704,30462
5001500US3620,3620,"Congressional District 20 (115th Congress), New York",577688,41552,536136,276662,90151,91443,46866,29060,19142,301026,90418,95695,50289,32969,31655
5001500US3621,3621,"Congressional District 21 (115th Congress), New York",554692,56366,498326,278956,83449,95325,48565,31573,20044,275736,73621,91222,48425,33413,29055
5001500US3622,3622,"Congressional District 22 (115th Congress), New York",560369,49977,510392,274485,83125,88928,48880,31379,22173,285884,79227,89112,49454,34598,33493
5001500US3623,3623,"Congressional District 23 (115th Congress), New York",563820,52578,511242,277323,87959,86053,49844,31849,21618,286497,83459,87220,50519,34326,30973
5001500US3624,3624,"Congressional District 24 (115th Congress), New York",558879,44940,513939,269735,82406,90960,47936,28712,19721,289144,82412,94371,49900,32399,30062
5001500US3625,3625,"Congressional District 25 (115th Congress), New York",567213,37047,530166,269248,88461,87762,45296,28013,19716,297965,89051,95102,49273,33249,31290
5001500US3626,3626,"Congressional District 26 (115th Congress), New York",566762,44072,522690,266659,90678,82711,45401,27218,20651,300103,92106,89465,50667,33208,34657
5001500US3627,3627,"Congressional District 27 (115th Congress), New York",570024,49832,520192,282082,74202,100139,53304,33353,21084,287942,66817,98767,54357,35773,32228
5001500US3701,3701,"Congressional District 1 (115th Congress), North Carolina",582491,42846,539645,272937,91442,90670,45329,28697,16799,309554,95924,97884,51704,34807,29235
5001500US3702,3702,"Congressional District 2 (115th Congress), North Carolina",574715,55038,519677,274445,73316,113398,45709,28020,14002,300270,75936,121455,49245,31527,22107
5001500US3703,3703,"Congressional District 3 (115th Congress), North Carolina",542609,75410,467199,256172,75410,84371,44286,32814,19291,286437,82651,89391,49921,36361,28113
5001500US3704,3704,"Congressional District 4 (115th Congress), North Carolina",623523,37951,585572,296877,112773,111207,39465,21546,11886,326646,118787,116278,45658,26323,19600
5001500US3705,3705,"Congressional District 5 (115th Congress), North Carolina",583165,48010,535155,278924,81376,96188,47471,33185,20704,304241,82327,100005,52076,38154,31679
5001500US3706,3706,"Congressional District 6 (115th Congress), North Carolina",580828,49351,531477,276177,73611,100553,48892,32909,20212,304651,75275,106574,52770,38742,31290
5001500US3707,3707,"Congressional District 7 (115th Congress), North Carolina",598763,61767,536996,286722,81394,96536,49630,38556,20606,312041,81194,100066,56274,43841,30666
5001500US3708,3708,"Congressional District 8 (115th Congress), North Carolina",544550,72655,471895,252035,74251,89897,41699,28392,17796,292515,85528,100586,46871,33243,26287
5001500US3709,3709,"Congressional District 9 (115th Congress), North Carolina",564169,46996,517173,267351,72530,104610,45355,29177,15679,296818,75961,112253,49887,33148,25569
5001500US3710,3710,"Congressional District 10 (115th Congress), North Carolina",582118,50883,531235,277816,74125,100077,49277,34540,19797,304302,75996,103291,54277,39662,31076
5001500US3711,3711,"Congressional District 11 (115th Congress), North Carolina",596760,58735,538025,286513,71348,94711,50761,42458,27235,310247,69349,96680,57352,48214,38652
5001500US3712,3712,"Congressional District 12 (115th Congress), North Carolina",611102,37651,573451,290371,111599,112831,36858,19276,9807,320731,115740,120605,42337,24514,17535
5001500US3713,3713,"Congressional District 13 (115th Congress), North Carolina",585371,45928,539443,276092,81000,99483,46062,30354,19193,309279,88133,105147,49945,35758,30296
5001500US3800,3800,"Congressional District (at Large) (115th Congress), North Dakota",562348,49560,512788,285498,102518,89073,46992,26707,20208,276850,91003,82853,45164,27455,30375
5001500US3901,3901,"Congressional District 1 (115th Congress), Ohio",551300,42666,508634,265574,84842,93910,44303,25819,16700,285726,84237,97131,48560,29446,26352
5001500US3902,3902,"Congressional District 2 (115th Congress), Ohio",556576,46766,509810,266569,77078,94254,47906,28459,18872,290007,76706,98401,51782,33241,29877
5001500US3903,3903,"Congressional District 3 (115th Congress), Ohio",570259,40869,529390,272122,110224,93569,37557,19270,11502,298137,114513,98036,42901,24503,18184
5001500US3904,3904,"Congressional District 4 (115th Congress), Ohio",549101,51368,497733,272333,76990,94501,50370,30202,20270,276768,70269,92041,50608,33593,30257
5001500US3905,3905,"Congressional District 5 (115th Congress), Ohio",559370,47841,511529,271240,80312,89999,49615,30882,20432,288130,78996,91842,51170,34407,31715
5001500US3906,3906,"Congressional District 6 (115th Congress), Ohio",556603,56441,500162,274890,71104,91769,53720,35694,22603,281713,64821,91358,53633,37885,34016
5001500US3907,3907,"Congressional District 7 (115th Congress), Ohio",553943,51484,502459,268115,72052,92175,49677,32981,21230,285828,71422,93059,52726,36694,31927
5001500US3908,3908,"Congressional District 8 (115th Congress), Ohio",551084,50694,500390,266523,78566,92490,46791,29585,19091,284561,78623,94576,49426,33333,28603
5001500US3909,3909,"Congressional District 9 (115th Congress), Ohio",551608,45145,506463,263313,82737,91067,45122,26508,17879,288295,85045,94351,48829,31357,28713
5001500US3910,3910,"Congressional District 10 (115th Congress), Ohio",557383,60466,496917,263733,81485,86123,45832,29515,20778,293650,83453,91780,50787,35332,32298
5001500US3911,3911,"Congressional District 11 (115th Congress), Ohio",542545,39082,503463,248844,82052,79180,45290,24256,18066,293701,86624,91200,51133,32641,32103
5001500US3912,3912,"Congressional District 12 (115th Congress), Ohio",572522,46917,525605,280053,82407,106233,46100,28442,16871,292469,79172,105489,49485,32475,25848
5001500US3913,3913,"Congressional District 13 (115th Congress), Ohio",567363,52612,514751,272508,83758,88353,48270,30138,21989,294855,82006,89276,53449,35585,34539
5001500US3914,3914,"Congressional District 14 (115th Congress), Ohio",558610,48660,509950,269652,66049,94299,52492,34097,22715,288958,62779,97961,55437,37925,34856
5001500US3915,3915,"Congressional District 15 (115th Congress), Ohio",576247,49148,527099,288552,92971,103140,46816,28266,17359,287695,84343,97882,47521,31770,26179
5001500US3916,3916,"Congressional District 16 (115th Congress), Ohio",564463,49028,515435,272200,69298,93703,51935,33470,23794,292263,68316,97680,53319,36901,36047
5001500US4001,4001,"Congressional District 1 (115th Congress), Oklahoma",583102,51724,531378,279835,90102,98614,45648,27650,17821,303267,91328,101534,50159,32842,27404
5001500US4002,4002,"Congressional District 2 (115th Congress), Oklahoma",571199,58803,512396,281026,80344,92778,47335,36941,23628,290173,76220,91888,50619,40057,31389
5001500US4003,4003,"Congressional District 3 (115th Congress), Oklahoma",581733,55050,526683,291609,95608,96461,47241,31136,21163,290124,86385,91348,48364,34386,29641
5001500US4004,4004,"Congressional District 4 (115th Congress), Oklahoma",579397,67593,511804,282398,97137,94007,44369,28567,18318,296999,94332,96430,47537,32568,26132
5001500US4005,4005,"Congressional District 5 (115th Congress), Oklahoma",589978,53756,536222,283029,97360,96954,44881,26736,17098,306949,99819,100117,48605,31747,26661
5001500US4101,4101,"Congressional District 1 (115th Congress), Oregon",619128,51662,567466,302582,93686,113234,48531,30168,16963,316546,92210,112347,52491,33560,25938
5001500US4102,4102,"Congressional District 2 (115th Congress), Oregon",614276,72188,542088,303217,81548,95748,55356,42875,27690,311059,76014,95404,59493,45283,34865
5001500US4103,4103,"Congressional District 3 (115th Congress), Oregon",646866,45811,601055,317941,105481,118964,49842,28188,15466,328925,107644,114307,51708,31660,23606
5001500US4104,4104,"Congressional District 4 (115th Congress), Oregon",629133,71802,557331,308279,94682,89253,54938,42550,26856,320854,89819,91397,59650,44826,35162
5001500US4105,4105,"Congressional District 5 (115th Congress), Oregon",608949,59867,549082,296192,86954,100304,51424,35494,22016,312757,83920,101350,56079,39806,31602
5001500US4201,4201,"Congressional District 1 (115th Congress), Pennsylvania",550612,27738,522874,260387,101294,89427,37276,19871,12519,290225,104225,95027,42220,26324,22429
5001500US4202,4202,"Congressional District 2 (115th Congress), Pennsylvania",567850,31237,536613,253997,104024,75512,36805,22300,15356,313853,120571,86156,47403,31939,27784
5001500US4203,4203,"Congressional District 3 (115th Congress), Pennsylvania",550613,54632,495981,267603,73066,90197,49878,31519,22943,283010,70466,91068,51114,35399,34963
5001500US4204,4204,"Congressional District 4 (115th Congress), Pennsylvania",558248,52151,506097,271294,76210,96435,47645,30397,20607,286954,74690,97552,50081,34185,30446
5001500US4205,4205,"Congressional District 5 (115th Congress), Pennsylvania",572629,54815,517814,292109,96648,91013,49692,32527,22229,280520,81465,82787,49254,34185,32829
5001500US4206,4206,"Congressional District 6 (115th Congress), Pennsylvania",559857,43517,516340,270308,75076,98036,47579,29226,20391,289549,74072,101025,50596,32586,31270
5001500US4207,4207,"Congressional District 7 (115th Congress), Pennsylvania",557065,39906,517159,269416,73100,95267,49901,28564,22584,287649,68305,98288,51580,34488,34988
5001500US4208,4208,"Congressional District 8 (115th Congress), Pennsylvania",555834,41688,514146,269553,68261,97770,52085,30559,20878,286281,65675,101029,53545,34084,31948
5001500US4209,4209,"Congressional District 9 (115th Congress), Pennsylvania",555378,56010,499368,271133,74265,89091,49745,34049,23983,284245,70312,88834,51015,37201,36883
5001500US4210,4210,"Congressional District 10 (115th Congress), Pennsylvania",557924,56024,501900,278195,74745,93057,51383,35390,23620,279729,67842,89828,51337,37492,33230
5001500US4211,4211,"Congressional District 11 (115th Congress), Pennsylvania",563313,55051,508262,275351,77787,92874,49864,33386,21440,287962,72755,92262,51800,36453,34692
5001500US4212,4212,"Congressional District 12 (115th Congress), Pennsylvania",560613,54221,506392,271111,65880,91027,54030,33965,26209,289502,61487,92817,56198,38418,40582
5001500US4213,4213,"Congressional District 13 (115th Congress), Pennsylvania",556783,34443,522340,263054,84217,90003,43243,26102,19489,293729,83174,99813,47868,29849,33025
5001500US4214,4214,"Congressional District 14 (115th Congress), Pennsylvania",578866,47968,530898,274132,101509,79550,46482,26259,20332,304734,100736,82454,52196,33417,35931
5001500US4215,4215,"Congressional District 15 (115th Congress), Pennsylvania",563038,46046,516992,272048,78945,93940,47055,30500,21608,290990,79329,95184,49585,34171,32721
5001500US4216,4216,"Congressional District 16 (115th Congress), Pennsylvania",542459,41109,501350,261542,80662,90305,42771,27271,20533,280917,81257,92971,45242,30679,30768
5001500US4217,4217,"Congressional District 17 (115th Congress), Pennsylvania",556903,51888,505015,270430,76780,92065,48448,31328,21809,286473,70849,92751,49956,35838,37079
5001500US4218,4218,"Congressional District 18 (115th Congress), Pennsylvania",566948,51814,515134,274329,68424,95650,52610,33673,23972,292619,63704,96607,54725,38749,38834
5001500US4401,4401,"Congressional District 1 (115th Congress), Rhode Island",416826,29726,387100,197959,64872,65979,32421,20242,14445,218867,64739,70790,36034,22894,24410
5001500US4402,4402,"Congressional District 2 (115th Congress), Rhode Island",422056,33164,388892,201689,61324,68657,35696,21616,14396,220367,62016,71700,38137,24859,23655
5001500US4501,4501,"Congressional District 1 (115th Congress), South Carolina",560333,71500,488833,264350,78834,89684,41764,34764,19304,295983,84775,96938,49967,39671,24632
5001500US4502,4502,"Congressional District 2 (115th Congress), South Carolina",518981,57244,461737,247042,73615,87520,42627,28248,15032,271939,74447,95099,47058,32197,23138
5001500US4503,4503,"Congressional District 3 (115th Congress), South Carolina",524733,47923,476810,253977,74671,84969,43220,32723,18394,270756,72831,87088,46902,36047,27888
5001500US4504,4504,"Congressional District 4 (115th Congress), South Carolina",533234,43980,489254,253895,77693,91187,40947,27521,16547,279339,80515,95040,45726,32785,25273
5001500US4505,4505,"Congressional District 5 (115th Congress), South Carolina",522167,52282,469885,248721,70015,89426,43239,30143,15898,273446,71963,94985,47574,34276,24648
5001500US4506,4506,"Congressional District 6 (115th Congress), South Carolina",516993,48065,468928,247576,91767,75917,38998,26435,14459,269417,88986,80671,45550,31091,23119
5001500US4507,4507,"Congressional District 7 (115th Congress), South Carolina",542055,52896,489159,255981,69215,83659,45916,37804,19387,286074,71105,90759,53954,42662,27594
5001500US4600,4600,"Congressional District (at Large) (115th Congress), South Dakota",638836,62661,576175,318163,100392,103390,55926,34014,24441,320673,94162,99896,55861,34851,35903
5001500US4701,4701,"Congressional District 1 (115th Congress), Tennessee",565887,57284,508603,273471,71024,94421,48054,37852,22120,292416,70070,95777,52708,41653,32208
5001500US4702,4702,"Congressional District 2 (115th Congress), Tennessee",573101,52279,520822,274821,83635,93107,45429,33167,19483,298280,84184,96831,50082,37754,29429
5001500US4703,4703,"Congressional District 3 (115th Congress), Tennessee",566744,53484,513260,273480,75674,94151,48367,34460,20828,293264,75112,96263,52469,37889,31531
5001500US4704,4704,"Congressional District 4 (115th Congress), Tennessee",568370,50338,518032,275430,86217,99101,43590,29880,16642,292940,85985,101253,47376,33963,24363
5001500US4705,4705,"Congressional District 5 (115th Congress), Tennessee",584118,39182,544936,278311,103259,98231,41020,22715,13086,305807,110072,100001,46210,27277,22247
5001500US4706,4706,"Congressional District 6 (115th Congress), Tennessee",567354,51605,515749,274391,74532,96859,46669,35933,20398,292963,73095,100946,50872,39442,28608
5001500US4707,4707,"Congressional District 7 (115th Congress), Tennessee",543533,59437,484096,261535,75185,96025,43920,29649,16756,281998,77289,101267,46820,32126,24496
5001500US4708,4708,"Congressional District 8 (115th Congress), Tennessee",539607,49983,489624,257106,69886,91610,45713,31534,18363,282501,70259,98367,50501,34876,28498
5001500US4709,4709,"Congressional District 9 (115th Congress), Tennessee",526437,37307,489130,244254,92537,84411,37959,18892,10455,282183,97240,93712,45355,25487,20389
5001500US4801,4801,"Congressional District 1 (115th Congress), Texas",534919,46779,488140,258100,82137,84484,42646,28946,19887,276819,82185,87418,45323,33238,28655
5001500US4802,4802,"Congressional District 2 (115th Congress), Texas",573276,34288,538988,286399,101936,106675,43948,22751,11089,286877,92880,105982,45810,26867,15338
5001500US4803,4803,"Congressional District 3 (115th Congress), Texas",577524,36247,541277,279344,82457,122932,39974,22477,11504,298180,83280,128024,43521,26562,16793
5001500US4804,4804,"Congressional District 4 (115th Congress), Texas",544311,55615,488696,265116,74256,92813,45676,32285,20086,279195,71765,95161,47862,36009,28398
5001500US4805,4805,"Congressional District 5 (115th Congress), Texas",537062,41277,495785,268442,86806,99915,40054,25981,15686,268620,79535,93906,42480,29534,23165
5001500US4806,4806,"Congressional District 6 (115th Congress), Texas",548507,43637,504870,261876,86164,100317,40056,23248,12091,286631,89707,108179,43966,26150,18629
5001500US4807,4807,"Congressional District 7 (115th Congress), Texas",559112,27969,531143,272726,93942,103175,42200,20475,12934,286386,91626,109093,43108,24134,18425
5001500US4808,4808,"Congressional District 8 (115th Congress), Texas",582355,49963,532392,295840,90947,112138,46989,29814,15952,286515,81789,104307,47485,31105,21829
5001500US4809,4809,"Congressional District 9 (115th Congress), Texas",557469,25486,531983,268379,105709,97225,36801,19059,9585,289090,106507,100740,43383,22998,15462
5001500US4810,4810,"Congressional District 10 (115th Congress), Texas",580757,41482,539275,287773,92372,112536,44017,25134,13714,292984,90669,109047,45457,27013,20798
5001500US4811,4811,"Congressional District 11 (115th Congress), Texas",552956,49721,503235,274701,93437,87124,43541,29847,20752,278255,84419,86137,46043,32810,28846
5001500US4812,4812,"Congressional District 12 (115th Congress), Texas",564975,53645,511330,272032,90985,98926,41743,25063,15315,292943,93480,102554,45338,29025,22546
5001500US4813,4813,"Congressional District 13 (115th Congress), Texas",522749,47883,474866,262363,84701,89521,42728,26867,18546,260386,77313,83192,43475,29932,26474
5001500US4814,4814,"Congressional District 14 (115th Congress), Texas",548468,47108,501360,276866,87041,100997,46836,26405,15587,271602,79397,94545,46430,28335,22895
5001500US4815,4815,"Congressional District 15 (115th Congress), Texas",513139,29645,483494,249091,93627,89262,30562,21276,14364,264048,90551,93886,35086,24348,20177
5001500US4816,4816,"Congressional District 16 (115th Congress), Texas",509632,46616,463016,238723,87388,82654,33408,20246,15027,270909,89530,93338,39201,25270,23570
5001500US4817,4817,"Congressional District 17 (115th Congress), Texas",567158,43206,523952,278807,116271,86919,37751,22827,15039,288351,111567,89143,39891,26236,21514
5001500US4818,4818,"Congressional District 18 (115th Congress), Texas",547207,26496,520711,269382,107185,98412,35866,18659,9260,277825,103170,97599,38622,21590,16844
5001500US4819,4819,"Congressional District 19 (115th Congress), Texas",536701,40974,495727,270330,104520,85185,38926,23818,17881,266371,93083,80169,39683,27497,25939
5001500US4820,4820,"Congressional District 20 (115th Congress), Texas",554919,56304,498615,267658,105424,94040,34525,20881,12788,287261,103117,98771,39721,25272,20380
5001500US4821,4821,"Congressional District 21 (115th Congress), Texas",601888,65136,536752,293139,99015,95750,46184,31850,20340,308749,97339,98718,50099,34164,28429
5001500US4822,4822,"Congressional District 22 (115th Congress), Texas",585300,35216,550084,283464,85749,117409,44575,23584,12147,301836,88357,123894,45558,26059,17968
5001500US4823,4823,"Congressional District 23 (115th Congress), Texas",524256,45796,478460,261422,90763,92279,37144,25674,15562,262834,82019,91796,40550,27606,20863
5001500US4824,4824,"Congressional District 24 (115th Congress), Texas",578440,36483,541957,280578,95245,111916,41291,20423,11703,297862,97278,113005,44239,24659,18681
5001500US4825,4825,"Congressional District 25 (115th Congress), Texas",549253,56889,492364,262225,78592,97068,42491,27838,16236,287028,87028,101765,45680,30569,21986
5001500US4826,4826,"Congressional District 26 (115th Congress), Texas",575823,45028,530795,278966,89331,119872,39005,21225,9533,296857,93820,123026,41748,23942,14321
5001500US4827,4827,"Congressional District 27 (115th Congress), Texas",541045,52878,488167,264088,84031,87596,44847,28951,18663,276957,81348,90642,46368,31705,26894
5001500US4828,4828,"Congressional District 28 (115th Congress), Texas",502823,37296,465527,241460,87178,87194,32290,21288,13510,261363,85383,95055,36927,25328,18670
5001500US4829,4829,"Congressional District 29 (115th Congress), Texas",501551,17359,484192,252428,100702,94877,32500,15895,8454,249123,94399,90655,33032,17815,13222
5001500US4830,4830,"Congressional District 30 (115th Congress), Texas",535527,31816,503711,254310,91447,95151,38951,18849,9912,281217,96235,102070,42197,23257,17458
5001500US4831,4831,"Congressional District 31 (115th Congress), Texas",554031,73794,480237,264735,86430,103386,37184,23970,13765,289296,91604,108487,41607,27963,19635
5001500US4832,4832,"Congressional District 32 (115th Congress), Texas",563307,33287,530020,275103,94129,102062,41184,23698,14030,288204,92555,104550,43321,27054,20724
5001500US4833,4833,"Congressional District 33 (115th Congress), Texas",491983,18465,473518,246960,98257,93066,31375,15527,8735,245023,91485,89205,31616,18767,13950
5001500US4834,4834,"Congressional District 34 (115th Congress), Texas",501986,29345,472641,245206,87485,82223,33585,24060,17853,256780,80884,85964,37699,28106,24127
5001500US4835,4835,"Congressional District 35 (115th Congress), Texas",569577,43898,525679,282978,120078,98760,35273,17743,11124,286599,111799,97437,37369,22300,17694
5001500US4836,4836,"Congressional District 36 (115th Congress), Texas",541232,46267,494965,269810,83538,95809,45440,29024,15999,271422,78041,94789,46854,29685,22053
5001500US4901,4901,"Congressional District 1 (115th Congress), Utah",496952,39039,457913,246928,92585,86361,35016,20078,12888,250024,90824,86126,35352,21177,16545
5001500US4902,4902,"Congressional District 2 (115th Congress), Utah",521840,37103,484737,261859,96612,86720,36301,24755,17471,259981,93160,81645,37267,26839,21070
5001500US4903,4903,"Congressional District 3 (115th Congress), Utah",503841,24850,478991,248788,105465,79411,32302,19358,12252,255053,103628,81220,33422,21187,15596
5001500US4904,4904,"Congressional District 4 (115th Congress), Utah",516519,28756,487763,256974,97753,97670,32297,18162,11092,259545,94840,93382,34451,20820,16052
5001500US5000,5000,"Congressional District (at Large) (115th Congress), Vermont",504152,42484,461668,245722,70578,80127,46734,30341,17942,258430,68336,83158,49026,31987,25923
5001500US5101,5101,"Congressional District 1 (115th Congress), Virginia",569631,80172,489459,274832,75093,105257,46677,30522,17283,294799,77573,111141,49058,33628,23399
5001500US5102,5102,"Congressional District 2 (115th Congress), Virginia",528749,93551,435198,246186,78584,83973,41387,26090,16152,282563,86443,94341,46746,30865,24168
5001500US5103,5103,"Congressional District 3 (115th Congress), Virginia",547862,85938,461924,253214,92325,82290,40388,23122,15089,294648,99441,94751,45980,29475,25001
5001500US5104,5104,"Congressional District 4 (115th Congress), Virginia",586267,64512,521755,280528,93210,97310,47668,27138,15202,305739,95196,102078,51714,31857,24894
5001500US5105,5105,"Congressional District 5 (115th Congress), Virginia",581874,56192,525682,279677,78519,90918,50439,37076,22725,302197,77931,94982,54765,41489,33030
5001500US5106,5106,"Congressional District 6 (115th Congress), Virginia",591711,52498,539213,282918,88427,91401,47377,33563,22150,308793,91261,94702,51310,37640,33880
5001500US5107,5107,"Congressional District 7 (115th Congress), Virginia",578796,55852,522944,277779,78791,105433,46519,30051,16985,301017,76968,110300,52699,34634,26416
5001500US5108,5108,"Congressional District 8 (115th Congress), Virginia",604167,50735,553432,292798,104496,112250,40452,22572,13028,311369,108222,114250,44725,25235,18937
5001500US5109,5109,"Congressional District 9 (115th Congress), Virginia",581454,47169,534285,287583,86542,93143,48854,36470,22574,293871,77264,90790,51927,40625,33265
5001500US5110,5110,"Congressional District 10 (115th Congress), Virginia",577667,53293,524374,281901,75368,121515,45930,25865,13223,295766,77113,125533,46396,28608,18116
5001500US5111,5111,"Congressional District 11 (115th Congress), Virginia",585255,56773,528482,283695,91904,110659,44487,23878,12767,301560,91203,117129,47098,26961,19169
5001500US5301,5301,"Congressional District 1 (115th Congress), Washington",545623,43476,502147,270816,76754,106736,46352,27120,13854,274807,73359,104763,48024,29160,19501
5001500US5302,5302,"Congressional District 2 (115th Congress), Washington",548073,57355,490718,268971,86064,90626,45133,29445,17703,279102,83819,89783,48133,32239,25128
5001500US5303,5303,"Congressional District 3 (115th Congress), Washington",530448,59274,471174,259827,70957,91064,46391,32748,18667,270621,69827,92649,48943,34864,24338
5001500US5304,5304,"Congressional District 4 (115th Congress), Washington",498119,42025,456094,249324,81747,85367,40042,26363,15805,248795,77497,83186,40420,26704,20988
5001500US5305,5305,"Congressional District 5 (115th Congress), Washington",538847,62905,475942,265110,87637,83023,45318,30407,18725,273737,84733,82754,47767,32380,26103
5001500US5306,5306,"Congressional District 6 (115th Congress), Washington",534935,81304,453631,261726,71208,82466,49899,36736,21417,273209,68062,84610,53541,39028,27968
5001500US5307,5307,"Congressional District 7 (115th Congress), Washington",612151,38740,573411,303295,112676,104646,44502,26031,15440,308856,110420,97866,47031,28995,24544
5001500US5308,5308,"Congressional District 8 (115th Congress), Washington",532523,51039,481484,262617,75296,102680,45327,25658,13656,269906,73608,103657,46468,27184,18989
5001500US5309,5309,"Congressional District 9 (115th Congress), Washington",557359,38404,518955,276755,93150,102598,41666,22423,16918,280604,86250,99796,43026,27375,24157
5001500US5310,5310,"Congressional District 10 (115th Congress), Washington",523182,78341,444841,249225,79827,86479,41340,25982,15597,273957,84683,90819,45953,29387,23115
5001500US5401,5401,"Congressional District 1 (115th Congress), West Virginia",496566,47086,449480,245178,74858,79544,42813,29430,18533,251388,69114,77186,44581,32275,28232
5001500US5402,5402,"Congressional District 2 (115th Congress), West Virginia",489670,52137,437533,238864,61788,83259,44640,30645,18532,250806,60850,84391,46674,33032,25859
5001500US5403,5403,"Congressional District 3 (115th Congress), West Virginia",479155,45948,433207,233010,61410,77326,44320,31386,18568,246145,59333,78328,46852,33336,28296
5001500US5501,5501,"Congressional District 1 (115th Congress), Wisconsin",547493,46599,500894,269022,73807,99188,49117,28555,18355,278471,70945,99183,50640,30975,26728
5001500US5502,5502,"Congressional District 2 (115th Congress), Wisconsin",578621,39527,539094,284311,99229,95626,45945,26815,16696,294310,95432,96535,47933,29284,25126
5001500US5503,5503,"Congressional District 3 (115th Congress), Wisconsin",565218,51675,513543,282262,91519,89146,48643,31477,21477,282956,87147,84593,48341,32220,30655
5001500US5504,5504,"Congressional District 4 (115th Congress), Wisconsin",531609,31653,499956,251511,96897,84884,37515,19153,13062,280098,102448,91766,40719,23369,21796
5001500US5505,5505,"Congressional District 5 (115th Congress), Wisconsin",562079,43642,518437,273055,76001,96954,50285,28939,20876,289024,72980,97405,51891,32762,33986
5001500US5506,5506,"Congressional District 6 (115th Congress), Wisconsin",558190,48886,509304,279252,77502,97215,51455,31037,22043,278938,69925,92245,50538,33650,32580
5001500US5507,5507,"Congressional District 7 (115th Congress), Wisconsin",552528,55743,496785,277024,66164,94267,54553,37134,24906,275504,61189,91321,53106,36913,32975
5001500US5508,5508,"Congressional District 8 (115th Congress), Wisconsin",555141,49502,505639,275230,76034,98870,49674,30173,20479,279911,72425,97211,49251,32199,28825
5001500US5600,5600,"Congressional District (at Large) (115th Congress), Wyoming",441797,47390,394407,223887,71269,73541,40865,23910,14302,217910,65586,70064,39765,23941,18554
5001500US7298,7298,"Resident Commissioner District (at Large) (115th Congress), Puerto Rico",2760775,89824,2670951,1290979,395760,429709,198413,158604,108493,1469796,404707,481822,236132,192713,154422
